
NO ./textures/1.xpm
SO ./textures/2.xpm
WE ./textures/3.xpm
EA ./textures/4.xpm


F 54, 60, 255
C 242, 191, 193     

  11111111111111111111111111111
  11100000000000010001100000011
11000000000100000011110011011
10011000011111110000000000001
1001100001   1000000000001111
1000000001   1000000000000001
1111000001   1111111111110001
1000001101   1000000000000001
10000011011111000011111111101
1000000000010000001       101
10011111100000110011111111101
100000000001000000000000N0001
1111111111111111111111111111
