

NO ./textures/1.xpm
SO ./textures/2.xpm
WE ./textures/3.xpm
EA ./textures/4.xpm
F 82,56, 50
C 138, 209, 227


     111111                   111   11111        
        10111111111111111111111011111000111111111    
        10000000001100000000000000000010000000001
        10110000011100000000000011111100111111101
        1001000000000000000000001   10001     101    
111111111011000001110000000000001   11011     101
100000000011000001110111110111111   11011     101
11110111111111011100000010001       11011     101
11110111111111011101010010001       100011  11101    
11000000110101011100000010001       110001  10001
1000000000000000110000001000111111111101011110111
100000000000000011010100100000000000000000000001
110000011101010111110111100011111111111111011111
1111S111 1110101 100000000001            101
11111111 1110111 111111111111            101
           101                           101
           101                           101
           1011111111111111111111111111111011
           10000000000000000000000000000000101
           1111111111111111111111111111111111