



NO ./textures/1.xpm
SO ./textures/2.xpm
WE ./textures/3.xpm
EA ./textures/4.xpm

F 153,204,255
C 0,76,153

    

1111111111
1N00000001
1011111101
1011001101
1011001101
1011011101
1000000001
1111111111





